# Context Descs
CtxAttackDesc=Angreifen
CtxDefendDesc=Verteidigen
CtxGuardDesc=Bewachen
CtxArmDesc=Bewaffnen
CtxUnbuckleDesc=Ablegen
CtxNoItemsToUnbuckle=Keine Gegenstände angelegt
CtxUnbuckleItem=%s ablegen
CtxAntiSleep=Letzte Kraft

# Control Descs
CtrlInventoryDesc=Inventar auswählen
CtrlActivateDesc=Ablegen

# Messages
MsgWatch=%d Uhr und alles ist %s.
MsgWatchStateWell=gut
MsgWatchStateBad=arrrrrgghhhh
MsgNoEnemy=Kein Angriffsziel!
MsgNoArrow=Kein Pfeil.
MsgNoSpear=Kein Speer.
MsgNoWeapons=Keine Waffen.
MsgArmed=Bewaffnet.
MsgEnemyDeath=%s erledigt.
MsgEnemyHostChanged=%s gehört|jetzt zu uns.

# VHStrings
VHPain=Schmerz: %d/%d|
VHTiredness=Müdigkeit: %d/%d|
VHHunger=Hunger: %d/1000|
VHLsotBlood=Blutverlust: %d/80

VHDoping=Imprägnieren mit %s
VHDoped=Ihr tragt %s auf das %s auf.
VHCtxDope=Waffe imprägnieren

VHCtxAlchem=Alchemie
VHProduce=Herstellen: %s
VHNotEnough=Nicht genug %s

VHCtxFillBlood=Blutflasche füllen
VHFillBlood=Ihr füllt 25 ml eures Blutes in eine Flasche

VHCtxInvisible=Unsichtbar werden
VHCtxVisible=Sichtbar werden

VHCtxHeal=Regeneration
VHCtxHealOff=Regeneration aus

VHKill=Töten
VHNotAble=Mit %s geht das nicht!

VHGuard=Bewachen
VHStopGuarding=Bewachen stoppen

VHDash=Sprinten

VHAbility=Fähigkeiten

VHMakeSlave=Sklave erschaffen
VHMakeGhul=Ghul erschaffen
VHMakeLich=Lich erschaffen
VHMadeSlave=Ihr habt %s zu eurem treuen Diener gemacht.
VHToMuchSlaves1=Ihr dürft nicht noch mehr Sklaven beschwören! (Es sind maximal nur vier Ghule erlaubt)
VHToMuchSlaves2=Ihr dürft nicht noch mehr Sklaven beschwören! (Bei neun oder zehn Spielern sind nur drei Ghule erlaubt)
VHToMuchSlaves3=Ihr dürft nicht noch mehr Sklaven beschwören! (Bei sieben oder acht Spielern sind nur zwei Ghule erlaubt)
VHToMuchSlaves4=Ihr dürft nicht noch mehr Sklaven beschwören! (Bei fünf oder sechs Spielern ist nur ein Ghul erlaubt)
VHNoSlaves=Ich könnt keine Diener beschwören! (bei weniger als fünf Spielern ist kein Ghul erlaubt)
VHNewLife=%s hat euch mit der Macht seines Blutes zu einer neuen Existenz verholfen... enttäuscht ihn nicht!

VHCtxCheck=Überprüfen
VHCheckBlood1=|Leichter Blutverlust.
VHCheckBlood2=|Massiver Blutverlust.
VHCheckPains1=|Hat offenbar Schmerzen...
VHCheckPains2=|Hat offenbar starke Schmerzen.
VHCheckGhul=|Und er ist ein Ghoul.
VHCheckName=Es ist %s.%s%s%s

VHEat=Fressen
VHCrazy=Bist du verrückt?
VHFeelBetter=Euer Status hat sich teilweise erholt
VHMoreMeat=Menschenfleisch! MEHR!!, %s

VHSuckBlood=Blut saugen
VHDrinkBlood=Ihr trinkt %d ml Blut aus %s´s Adern

VHPainAura=Aura der Schmerzen

VHRide=Riten

VHPureWill=Reiner Wille
VHDontGiveUp1=Muss.... weiter.... machen!
VHDontGiveUp2=Es ist noch nicht vorbei!
VHDontGiveUp3=ARGH...

VHFormChange=Formwechsel

VHSacrifice=Blutopfer
VHAbortSacrifice=Blutopfer abbrechen

VHCtxDreamEater=Traumfresser

VHDarkAura=Schattenaura
VHAbortDarkAura=Schattenaura unterbrechen

VHLayDown=Hinlegen
VHSleep=Ahhhh... Wunderbar.
VHWhat=hm.. wasn?
VHStandUp=Aufstehen

VHHumanFood=Igitt... Menschenfutter!